1111111111
1000000001
1101111011
1000001011
1010201001
1010001101
1011111101
1000010001
1001000131
1111111111
