111111111111111111111
100001000010000100001
101010010000010111001
101000111111100000101
101001000000001010101
101101011101101100001
100000000000100001011
111011111111110111001
101001000000010010001
101100010000011000101
101010010020010011101
101001010000010100001
100000010000010010001
101111011111110011111
101000000010000100001
101001110101100000101
111011000100011111101
100010001101000010101
100011100101001000101
101000000001001000031
111111111111111111111
