200000000000000000000000000000
000000000000000000000000000000
000000000000000000000000000000
000000000000000000000000000000
111111110000000000000111100000
000000011111111111111100000001
000000000000000000000000000001
000000000000000000000000000001
000000000000000000000000000001
000000000000000000000000000001
000000000000000000000000000001
000000000000000000000000000011
000000000000000000000000000110
000011111111100000000000111100
000010000000111111111111100000
000110000000000000000000000000
000100000000000000000000000000
000100000000000000000000000000
000100000000000000000000000000
000110000011111110000000000000
000010000000000010000000111000
000010000000000010001111100001
000011100000000010001000000001
000000111100000010001000000001
000000000000000010001000000001
000000000000000010001000001110
000000000000000010001000001000
000000000000000010001000110000
000000000000001110001001100000
000000000111111000001000000003
