200000000000000000000000000000
000000000000000000000000000000
000000000000000000000000000000
100000000000000000000000000000
111111111111111111111111100000
000000000000000000000000110000
000000000000000000000000011000
000000000000000000000000000000
000000000000000000000000000001
000001111111000000000000000001
000011000001111000000000000001
000110000000001111000000000001
000100000000000001100000000011
000100000000000000111111111110
000100001111000000000000000000
000100011001000000000000000000
000100010001100000000000000000
000100010000100000001111111000
000100010000100000111000000000
000100010000100000100000000000
000100010000100000100000000000
000100010001100000100000000001
000100000001000001000000000001
000100000011000001000000000001
000100000010000001001111111111
000100000110000011001000000000
000110000100000010001000000000
000011111100000110001100100000
000000000000000100000111100000
000000000000001000000000000003
