1000011001000000111010111111000000010000
1200001100000000100000110001101000000000
1000101000000100000001000000110100000000
1001100000010010000001000010000000000100
1001000000100100100000010110001000000000
0011010111010101110000101100001000000000
0100000010111101101111100001111000010000
0110010000100111010011001100111100000011
0110001010110010000010110011101100010000
0100011000110001011101011010100001100010
0110111011001000100100000110100010101011
0110100001001010000011011010000110000011
1111101000110111010100110000011000010111
1110110100110111010000000000110110010101
0000010100001100010000000101100100000000
0001101000100011010001010111101101000111
1000000000011100001101010110000001011000
0011001010110000001001110101110011100100
0000001011000011111011110110100110000101
1100011000010100010101000011010110000000
0010000110100101110001000100100011101000
0101111100110011010110000110000000011111
0011111000101000010010001100011000110110
1000001000010100111001100010001001010100
1001010010001011010100001000011111111100
0010101010000100110001000101101001011000
1001000000011110001000001000011110001001
1101001010010111011001101000010010010110
1011010000110001000000010001110010111010
0010000000001100100100110001001000010000
0000001001001010101101100010100010100001
1100000001100010110110010000000010000010
0000011010101110000101110010010000000101
0000000101100011000000100100000001100010
1001100010001100011011001100000001010000
0110001000000110110100000000000000101000
1110000000111011100000000001011011000000
1110010110101011100100000001000111010110
1001100001001111000000001000101000101110
0101110110011000110000100000111100000003
