2000000000000000000000000000000000000000000000000
0000000000000000000000000000000000000000000000000
0000000000000000000000000000000000000000000000000
1100000000000000000000000000000000000000000000000
0011100000000000000000000000000000000000000000000
0000111111111000000000000000000000000000000000000
0000000000111100000000000000000000111000000000000
0000000000000011100000000000000000111000000000000
0000000000000000111111111111111111101110000000000
0000000000000000000000000000000000000011111000000
0000000000000000000000000000000000000000000111000
0000000000000000000000000000000000000000000000000
0000000000000000000000000000000000000000000000001
0000111110000000000000000000000000000000000000001
0000100011100000000000000000000000000000000000001
0000100000111000000000000000000000000000000000001
0000100000001111000001111111111111111000000000001
0000000000000001111111000000000000001110000000001
0000000000000000000000000000000000000001111000111
0000000000000000000000000000000000000000001111100
1000000000000000000000000000000000000000000000000
1000000000000000000000000000000000000000000000000
1100000000000000000000000000000000000000000000000
0100000000000000000000000000000000000000000000000
0110000000000000000000000000000000000000000000000
0011000000000000000000000000000000000000000000000
0001100000000000000000001111111111111111000000000
0000110000000000011111110000000000000001110000000
0000001111111111110000000000000000000000011000000
0000000000000000000000000000000000000000001100000
0000000000000000000000000000000000000000000111000
0000000000000000000000000000000000000000000000000
0000000000000000000000000000000000000000000000000
0000000000000000000000000111111000000000000000001
0000000000000000000000011100001110000000000000001
0000000000000000000000110000000011000000000000001
0000111110000000000011100000000001110000000000011
0000100011000000011110000000000000011111000000110
0001100000111111110000000000000000000000111111000
0001000000000000000000000000000000000000000000000
0001000000000000000000000000000000000000000000000
0001000000000000000000000000000000000000000000000
0001100000000000000000000000000000000000000000000
0000100000000000000000000000000000000000000000011
0000110000000000000000000000000000000000000000110
0000000000000000011111110000000000011111100010100
0000000000000001110000011000000001110000110011100
0000000000000111000000000100000011000000010011000
0000000111111100000000000011111110000000000000003
