10;10; // width/height
2;10 // start
1;7 // end
1111110111
1000000010
1011111010
1010100010
1010100010
0010100010
0010111110
1001010000
1100000100
1111111111

// 1 - block