000000003
000000000
000111100
000000100
000000100
000000100
002000000
000000000
000000000
