1111111111111111111111111
1210100000000000000100011
1010100010000011000100001
1010100010011111100000001
1010000111100000111111001
1010101100100000000001101
1000101000000100111100111
1010101000001101000100011
1010101010011000000100111
1110101100010000010010101
1100101001100011010010101
1101000000110010010110101
1001000000110110000100001
1100010001100100001101001
1110110001000100011001001
1000100001001000110001001
1000100011001000100101001
1000100010011000101101101
1000110110010001100000101
1010011100010101100000101
1010000000110100111110101
1011000001100100011000001
1001111111000101000000101
1100000000000100000001131
1111111111111111111111111
