1111111111
1000000001
1011111001
1000001001
1010201101
1010001001
1011111001
1000100001
1010001031
1111111111
